40
40
0000000000000000000000000000000000000000
0111111111111111112211111111111111111110
0111111111111111111111111111111111111110
0110000000000000000000000000000000000110
0110111111111111111111111111111111110110
0110111111111111111111111111111111110110
0110110000000000001100000000000000110110
0110110111111111111111111111111110110110
0110110111111111111111111111111110110110
0110110111111111111111111111111110110110
0110110111111111111111111111111110110110
0110110111111111111111111111111110110110
0110110111111111111111111111111110110110
0110110111111111111111111111111110110110
0110110111111111111111111111111110110110
0110110111111111111111111111111110110110
0110110111111111111111111111111110110110
0110110111111111111111111111111110110110
0110110111111111111111111111111110110110
0111110111111111111111111111111110111110
0111110111111111111111111111111110111110
0110110111111111111111111111111110110110
0110110111111111111111111111111110110110
0110110111111111111111111111111110110110
0110110111111111111111111111111110110110
0110110111111111111111111111111110110110
0110110111111111111111111111111110110110
0110110111111111111111111111111110110110
0110110111111111111111111111111110110110
0110110111111111111111111111111110110110
0110110111111111111111111111111110110110
0110110111111111111111111111111110110110
0110110111111111111111111111111110110110
0110110000000000001100000000000000110110
0110111111111111111111111111111111110110
0110111111111111111111111111111111110110
0110000000000000000000000000000000000110
0111111111111111111111111111111111111110
0111111111111111112211111111111111111110
0000000000000000000000000000000000000000